111111111111111111111111111111111111111111111111111111111111111111111111111111
1____________________________________________________________________________1
1____________________________________________________________________________1
1___1111111__________________________________________________________________1
1_____________________1111111111111111_____________11111111111_______________1
1____________________________________________________________________________1
1____________________________________________________________________________1
1_111111111111_______________________________________________________________1
1____________________________11111111________________________________________1
1_______________________________________________________________111111111____1
1____________________________________________________________________________1
1_____________________111111111111___________________________________________1
1____________11111__________________________111111111________________________1
1____________________________________________________________________________1
1111111111____________________111111_________________________________________1
1____________________________________________________________________________1
1_________________________________________________________________111111111111
11111111111111111______________________________11111_________________________1
1____________________________________________________________________________1
1____________________________________________________________________________1
1_________________1111111111______________________________11111111111________1
1____________________________________________________________________________1
1___________________________________11111111_________________________________1
1____________________________________________________________________________1
1___11111___________________________________________________1111111__________1
1__________________11111111__________________________________________________1
1____________________________________________________________________________1
1_________111_________________________1111111________________________________1
1_________________________11_________________________________________________1
1______________________________________________________11111111111111________1
1________1111111111__________________________________________________________1
1____________________________________________________________________________1
1___________________________111111_______________11111111____________________1
1____________________________________________________________________________1
1_______111111111__________________111_______________________________________1
1____________________________________________________________________________1
1_______________________________________11111111111__________________________1
1____________________________________________________________11111111111_____1
1__________________11111111_________________________111______________________1
1__________P_________________________________________________________________1
1___________________________________11111111_________________________________1
111111111111111111111111111111111111111111111111111111111111111111111111111111

