111111111111111111111111111111111111111111111
1___________________________________________1
1___________________________________________1
1___1111111_________________________________1
1_____________________1111111111111111______1
1___________________________________________1
1___________________________________________1
1_111111111111______________________________1
1____________________________11111111_______1
1___________________________________________1
1___________________________________________1
1_____________________111111111111__________1
1____________11111__________________________1
1___________________________________________1
1111111111__________________________________1
1___________________________________________1
1________________________________111111111111
11111111111111111___________________________1
1___________________________________________1
1___________________________________________1
1_________________1111111111________________1
1___________________________________________1
1______________________________11111111_____1
1______P____________________________________1
1___________________________________________1
111111111111111111111111111111111111111111111

